Proverbio filosofico con 4 parole semplici|La vita è un gioco
Proverbio sui pigri - contiene animali marini|Chi dorme non piglia pesci
Proverbio sul tempo - preferire il ritardo|Meglio tardi che mai
Frase famosa su tempo e ricchezza|Il tempo è denaro
Proverbio sulla collaborazione e forza|L'unione fa la forza
Metafora poetica su speranza dopo difficoltà|Ogni nuvola ha il suo arcobaleno
Frase breve su conoscenza e autorità|Il sapere è potere
Proverbio su dolci e imperfezioni|Non tutte le ciambelle riescono col buco
Proverbio sull'importanza di iniziare bene|Chi ben comincia è a metà dell'opera
Metafora su verità che emergono sempre|Tutti i nodi vengono al pettine
Proverbio sul crescere del desiderio|L'appetito vien mangiando
Proverbio su velocità e sicurezza|Chi va piano va sano e va lontano
Proverbio su vedere e soffrire|Occhio non vede cuore non duole
Contrasto tra orale e scritto|Le parole volano gli scritti rimangono
Proverbio su come inizia la giornata|Il buongiorno si vede dal mattino
Città eterna e costruzione nel tempo|Roma non fu costruita in un giorno
Ostacolo liquido tra intenzioni e azioni|Tra il dire e il fare c'è di mezzo il mare
Proverbio su regalo e critica|A caval donato non si guarda in bocca
Metallo prezioso e apparenze ingannevoli|Non è tutto oro quello che luccica
Vestito religioso e apparenza|L'abito non fa il monaco
Diversità come bellezza del mondo|Il mondo è bello perché è vario
Amicizia come ricchezza preziosa|Chi trova un amico trova un tesoro
Auto-aiuto e assistenza divina|Aiutati che il ciel ti aiuta
Elemento che rivela presenza di fuoco|Dove c'è fumo c'è fuoco
Pentole e coperchi del diavolo|Il diavolo fa le pentole ma non i coperchi
Desiderio eccessivo porta a perdere tutto|Chi troppo vuole nulla stringe
Viaggiare e adattarsi alle usanze locali|Paese che vai usanza che trovi
Ironia su chi ha strumenti ma non risorse|Chi ha i denti non ha il pane
Seminare male e raccogliere peggio|Chi semina vento raccoglie tempesta
Gatto traumatizzato dall'acqua|Gatto scottato dall'acqua calda ha paura anche di quella fredda
Festività natalizie e pasquali|Natale con i tuoi Pasqua con chi vuoi
Nuovo anno e nuovo inizio|Anno nuovo vita nuova
Auguri per il giorno della nascita|Buon compleanno
Auguri generici per occasioni speciali|Tanti auguri
Auguri per la festa di dicembre|Felice Natale
Auguri per l'inizio dell'anno|Buon anno
Augurio di successo e casualità positiva|Buona fortuna
Augurio teatrale per la buona sorte|In bocca al lupo
Disciplina che crea software e applicazioni|Programmazione informatica
Tecnologia che simula l'intelligenza umana|Intelligenza artificiale
Creazione di programmi e applicazioni|Sviluppo software
Innovazioni del nostro tempo|Tecnologia moderna
Rete di oggetti connessi|Internet delle cose
Mondo artificiale immersivo|Realtà virtuale
Piattaforme di comunicazione online|Social media
Fonti di energia pulita|Energia rinnovabile
Alterazione del clima globale|Cambiamento climatico
Rispetto per l'ambiente|Sostenibilità ambientale
Luogo del cuore e affetto|Casa dolce casa
Nucleo di persone unite e contente|Famiglia felice
Sentimento che dura per sempre|Amore eterno
Tranquillità globale senza conflitti|Pace nel mondo
Benessere fisico e mentale|Salute e benessere
Pizza classica con pomodoro e mozzarella|Pizza margherita
Pasta romana con uova e pancetta|Spaghetti alla carbonara
Dolce freddo al cacao|Gelato al cioccolato
Bevanda italiana forte e concentrata|Caffè espresso
Dolce al mascarpone della nonna|Tiramisù della nonna
Vacanza nella penisola italiana|Viaggio in Italia
Ferie estive sulla costa|Vacanze al mare
Vette coperte di neve bianca|Montagne innevate
Fine del giorno con colori caldi|Tramonto romantico
Cielo buio pieno di stelle|Notte stellata
Genere musicale colto e raffinato|Musica classica
Genere musicale energico degli anni '50|Rock and roll
Musica improvvisata e sofisticata|Jazz moderno
Musica italiana contemporanea|Pop italiano
Teatro musicale italiano tradizionale|Opera lirica
Genio rinascimentale artista e inventore|Leonardo da Vinci
Scultore del David e della Pietà|Michelangelo Buonarroti
Poeta della Divina Commedia|Dante Alighieri
Compositore del Rigoletto e dell'Aida|Giuseppe Verdi
Attore comico premio Oscar|Roberto Benigni
Sport nazionale con pallone rotondo|Calcio italiano
Sport di squadra con rete alta|Pallavolo femminile
Sport con racchette e pallina piccola|Tennis da tavolo
Sport acquatico con movimenti sincronizzati|Nuoto sincronizzato
Sport con corsa salti e lanci|Atletica leggera
Stagione dei fiori e rinascita|Primavera italiana
Stagione calda delle vacanze|Estate calda
Stagione delle foglie che cadono|Autunno dorato
Stagione fredda con neve|Inverno freddo
Vegetazione spontanea colorata|Fiori di campo